000000000000000000000000000000
000000000000000000000000000000
000000000000000000000000000000
000000000000000000000000000000
000000022222000000000000000000
000000000000000000000000000000
220000000000000002200000022000
612222222222222221500002211200
611111111111111111500001111100
611111111111111111500000110000
611111111111111111500000100000
611111111111111111500000100000
377777777777777777400000000000